AEResolveQTDataRefs	true	true
AME.EnablePresetDB	false	false
AME.EnableVideoLimiter	false	false
AME.EncoderHost.NoXMP	false	false
AME.UseExportProgressCallback	true	true
AVCIExport.Use_AVCI100_Not_2027_Flag	true	true
AddDebugClipInfoToTimelineTooltips	false	false
AddTimestampToLogFileNames	false	false
AddUTCTimestampToTraces	false	false
AllowDynamicLinkToOwnProjectType	false	false
AllowMergedClipsToBeOpenedAsSequences	false	false
ApplicationLanguage	en_US	en_US
ApplicationLanguageBilingual	false	false
AudioClockOffsetThreshold	0.20000000000000001	0.20000000000000001
AudioClockSkewCompensation	false	false
AudioClockSkewOffsetThreshold	0.050000000000000003	0.050000000000000003
AudioClockSkewSmoothingConstant	0.01	0.01
AudioDropoutDiskReadFallback	false	false
AudioDropoutTrackNonPurgeable	true	true
AudioForceNoDevices	false	false
AudioIOPreventSuspending	false	false
AudioIgnoreSetIOSettings	false	false
AudioMaxShuttleSpeed	4	4
AudioOutputOnlyUI	false	false
AudioPrefetchAlternative	true	true
AudioPrefetchDelayDisk	0	0
AudioPrefetchOverloadThreshold	110	110
AudioProcessingBypassingEnabled	true	true
BE.CompressProjects	true	true
BE.DisableCS7RelinkUpdate	false	false
BE.EnableNewSerializer	true	true
BE.Media.GetProperties.GetImporterTestingInfo	false	false
Bravo.defaultLanguage	false	false
CTPreDefinedEncodingType	13	13
CaptioningSmartRender	false	false
CloseAlwaysTimeoutInSeconds	300	300
CloseIfContentionTimeoutInSeconds	15	15
CodeProfiler_AutoStart	false	false
Color.AutoSelectionFollowsPlayhead	true	true
CompareMediaNodeRenderers	false	false
CreateLogFilesThatDoNotExist	false	false
DLG.DebugRelinkAsync	true	true
DS.DisablePixelFormatShaders	false	false
DS.EnableHalfDisplay	true	true
DS.ForceCPUOnly	false	false
DVA.ui.EnableStackedPanels	false	false
DisableGPUMediaNode	false	false
DisableHighQualityAVCHDPlayback	false	false
DisableNewMediaNodeRenderer	false	false
DisableSequenceSettingMasterChannelType	true	true
DisableSmartRenderingCS601	false	false
DisableSpeculativePrefetching	false	false
DistanceFromLastStateToNeedANewMPEGInfo	20	20
DumpProject	false	false
DvaMarshalRPCLogging	false	false
EnableAUSupport	true	true
EnableDogEars	false	false
EnableGPUDebayer	true	true
EnableMaskMultiSelect	false	false
EnableMatchSourceForAll	false	false
EnableOldMonitorScopes	false	false
EnableProxyUI	false	false
ExporterQT.DNxHDNativeSupportEnabled	false	false
ExporterXDCAMHD_DisableFileSinkBuffering	false	false
ExporterXDCAMHD_EnableFileSinkAppendMode	false	false
ExporterXDCAMHD_EnableTimer	false	false
ExporterXDCAMHD_PreInitializationCount	1	1
ExporterXDCAMHD_PreInitializationTriggerFrames	150	150
ExporterXDCAMHD_SinkBufferSize	1048576	1048576
ExporterXDCAMHD_UseDV25PALEncoding	false	false
FE.AudioPluginScanOnFirstLaunch	true	true
FE.PerformanceLogging	false	false
ForceMetadataWritable	false	false
ForceShowTrialUserDialog	false	false
GF.DisableAcceleratedDisplay	false	false
GF.DisableAcceleratedRenderer	false	false
GF.EnableMultipleGPUs	true	true
GF.ForceEnableZeroCopy	false	false
GF.ProfileKernels	false	false
GF.RedGPUDebayer	true	true
GF.SupportCPUDevices	false	false
GF.disable_cl_khr_image2d_from_buffer	false	false
GPU.EnableGOPFormats	false	false
HWEncodeEnable	true	true
HandlerProject.Hide.RecurseIntoBins	false	false
HandlerProject.Hide.RecurseIntoSequences	false	false
HandlerProject.HoverScrubDelay	250	250
HapticFeedBack2	true	true
IR.disableAVX	false	false
IR.disableAVX2	false	false
IgnoreDirtyState	false	false
ImporterDebugStrings	false	false
ImporterMXF.FailSafeTimeoutInSeconds	12	12
ImporterMXF.ReadBlockSizeinKB	1024	1024
ImporterMXFEnable	true	true
LegacyQTCodecsAndGamma	false	false
LinkLocate.Auto	true	true
LogTimeInTicks	true	true
MC.AudioRenderer.ComplexityBeforeRender	200	200
MC.BE.AddDocIDOnImport	true	true
MFDiskCacheManager.DefaultFreeSpacePercentagePerVolume	10	10
MFDiskCacheManager.DiskSweepInterval	600000	600000
ML.AudioSupport.ShowAudioDropoutWarnings	false	false
ML.DeprecateTransitions	true	true
ML.EnableDiskCache	false	false
ML.LoadTestingPluginsAtStartup	false	false
ML.MaxPlaybackSpeed	32	32
ML.SimulateGrowingFiles	false	false
ML.UseDVAAudioDeviceEngine	true	false
MPEGAllAudioRandomAccess	false	false
MPEGDisableMainConceptIndexing	false	false
MPEGDisableMultipleOpens	false	false
MZ.DisableMetadataDatabase	false	false
MZ.MetadataDatabaseIndexType	3	3
MZ.PreferMultichannelMasterTrack	false	false
MZ.ProjectManagerVerifyDependencies	false	false
MZ.SearchBinUpdateTimeout	5	5
MaxLogSize	0	0
MinimumDelayBetweenFlushesInSeconds	1	1
Monitor.PlaybackQuality	2	2
Monitor.PlaybackQualityIsHigh	2	2
Monitor.ScrubbingQuality	2	2
Monitor.ScrubbingQualityIsHigh	2	2
Monitor.StoppedQuality	4	4
Monitor.StoppedQualityIsHigh	4	4
MonitorMixerRenderQuality	2	2
NumberOfInstancesBeforeContention	5	5
PRM.ExecutionMode		
Player.EnablePerfomanceStatics	false	false
PlayerMain.MaxOutstandingPendingAheadOfPlayback	12	12
PlayerMain.MaxQueuedFrames	300	300
ProjectIconView.HoverScrubDownsampling	0	0
QE.EnableQEDOM	false	false
QE.MeasureSmartBinPerformance	false	false
QT.DisableQuickTime32	false	false
QT.EnableFastNativeProResDecode	true	true
QT.EnableNativeExports	true	true
QT.EnableNativeProResDecode8	true	true
QT.ForceReferenceMoviesToImporterQuickTime	false	false
QT.PreflightExternalReferences	true	true
QT32ServerManager.StartupTimeout	30000	30000
QTUseSourceGammaLevel	false	false
REDRocketCompletelyDisabled	false	false
REDRocketMaximumNumberOfCardsToUse	0	0
RTI.SI.enable	false	false
SM.ReduceDB	true	true
ScratchDiskHistoryLength	10	10
ShowExperimentalEffectParameters	false	false
SuppressInternalClipboard	false	false
SuppressPeakFileGeneration	false	false
TimeWarpFilterEnabled	false	false
TraceAsync	false	false
assert.enabled	false	false
color.RGBCurvesParamH	700	700
color.RGBCurvesParamV	280	280
dvaaudiodevice.EnableTestTone	false	false
